#######
#     #
# ### #
# #X  #
##### #
#S  # #
#######